# Map file for tile-based game
# (Lines that start with '#' are comments)
# The tiles are:
#   (Space) Empty tile
#   A..Z    Tiles A through Z
#   o       Frijol
#   !       Salsa
#   ,	    Tortilla
#   .       Queso
#   *       Goal
#   1       Gallinas
#   2       Borregos
                                                                C
                  2                                             C
                            CD                                  C
D                 A         CD    o        2BBBBBBBBBBBBBB .    C
D                 A  !      CD             B                    C
D                 A         CD             A                    C
D                BAB   BB   CD            B        *            C
D      1       BB  A     BB   BB          A                     C
D  BBBBB     BB    A 1B    BB   BB       B                      C
AB    ,D   BB       BB       BB   BB     A                      C
AAD          1               AA 2        A   1   2     1  2  1 1C
BBBBBBBBBBBBBBBBBBBBBBBBBBBBBBBBBBBBBBBBBBBBBBBBBBBBBBBBBBBBBBBBB